za - behind
nad - above, over
w pobliżu - nearby, close by
do tyłu - backward(s)
ku - toward(s)
na zewnątrz - outside, externally, outdoors
wewnątrz - inside, within, indoors
wokół - around
za granicą - overseas, abroad
blisko - near, close, nearby
daleko - far away, far, away
na górze - on top, upstairs, at the top, on the mountain
na dole - downstairs, at the bottom
tutaj - here
tam - there
wszędzie - everywhere
głęboko - deeply
obok - by, beside, next to, next
o - about
gdziekolwiek - anywhere
tu - here
w - in
północ - north
poza - off
na - on
południe - south
w kierunku - towards
pod - under, below
w górę - upwards, up
zachód - west
gdzie - where
poniżej - below, underneath, beneath
powyżej - above
przed - in front, before
tuż obok - next to, close to
gdzieś - somewhere
nigdzie - nowhere
do góry - upwards
w dół - downwards
z przodu - in front
z tyłu - at the back
w środku - inside, in the middle, in the midst
niejednokrotnie - everywhere
nikąd - nowhere
na środku - in the middle, in the center
po lewej stronie - on the left side
po prawej stronie - on the right side
na końcu - at the end
naokoło - around, about/around, surrounding
dokładnie naprzeciwko - exactly opposite
na zewnętrz - externally
w głębi - deep inside
na szczycie - on top
na dnie - at the bottom
na krawędzi - at the edge
pośrodku - in the midst
naprzeciwko - opposite
na wierzchu - on the surface
na peryferiach - on the outskirts
w przedniej części - in the front part
w tylnej części - in the back part
na samym końcu - at the very end
w sąsiedztwie - in the vicinity
na północy - in the north
na południu - in the south
na wschodzie - in the east
na zachodzie - in the west
w centralnym punkcie - at the central point
w promieniu - within a radius
wzdłuż - along
obok siebie - side by side
przy brzegu - by the shore
na przeciwko - opposite
w oddali - in the distance
na obrzeżach - on the outskirts
na wsi - in the countryside
na ulicy - on the street
w mieście - in the city
na dziedzińcu - in the courtyard
na podwórku - in the backyard
tuż przy - right by
na szlaku - on the trail
na ścieżce - on the path
na drodze - on the road
w przestrzeni - in space
w domu - at home
w biurze - at the office
na lotnisku - at the airport
na dworcu kolejowym - at the train station
w sklepie - in the store, in the shop
w restauracji - in the restaurant
na plaży - at the beach
w lesie - in the forest
w parku - in the park
w ogrodzie - in the garden
na polu - in the field
w rzece - in the river
na jeziorze - on the lake
na morzu - at sea
w górach - in the mountains
na wyspie - on the island
na pustyni - in the desert
w jaskini - in the cave
na zamku - at the castle
w pałacu - in the palace
w muzeum - at the museum, in the museum
w teatrze - at the theater
w kinie - at the cinema
na stadionie - at the stadium
na dworze - outdoors
w garażu - in the garage
w basenie - in the swimming pool
na boisku - on the field, on the sports field
w sali - in the hall
w klasie - in the classroom
na uczelni - at the university
w autobusie - on the bus
w samochodzie - in the car
na rowerze - on the bike
pieszo - on foot
w podróży - on a trip, in transit
w podróży służbowej - on a business trip
na wakacjach - on vacation
w drodze - on the way
w trakcie podróży - in the course of the journey
podróżując - while traveling
w trasie - en route
na miejscu - on site
na świeżym powietrzu - outdoors
na wolnym powietrzu - in the open air
pod chmurką - under the sky
u podstawy - at the base
w centrum - in the center
pomiędzy - between
na pierwszym piętrze - on the first floor
na drugim piętrze - on the second floor
na trzecim piętrze - on the third floor
na czwartym piętrze - on the fourth floor
na piątym piętrze - on the fifth floor
na szóstym piętrze - on the sixth floor
w piwnicy - in the basement
na parterze - on the ground floor
na poddaszu - in the attic
na tarasie - on the patio, on the terrace
na balkonie - on the balcony
w windzie - in the lift, in the elevator
na schodach - on the stairs
na ganku - on the porch
na werandzie - on the veranda
na chodniku - on the sidewalk
na parkingu - in the parking lot
na rynku - in the market
na placu - on the square
w parku rozrywki - at the amusement park
w zoo - at the zoo
w galerii sztuki - at the art gallery
w kawiarni - in the cafe
w bibliotece - in the library
w klubie - in the club
w centrum handlowym - at the shopping mall
na dworcu - at the station
w hotelu - in the hotel
w szkole - at school
na basenie - at the swimming pool
na kortach tenisowych - on the tennis courts
na lodowisku - at the ice rink
w pociągu - on the train
