zawsze - always
zazwyczaj - usually
często - often, frequently
czasami - sometimes
rzadko - seldom, rarely, infrequently
nigdy - never
codziennie - daily
regularnie - regularly
częstokroć - frequently
od czasu do czasu - from time to time
czasem - at times
okazjonalnie - occasionally
co jakiś czas - every now and then
sporadycznie - sporadically
niemal zawsze - almost always
prawie nigdy - almost never, hardly ever
bardzo rzadko - very rarely
zwykle - commonly, normally
czasem raz na - once in a while
nigdy więcej - never again
kiedykolwiek - ever
ogólnie - generally
raz - once
dwa razy - twice
ciągle - constantly
rocznie - yearly, annually
dziennie - daily
co dwa tygodnie - fortnightly
godzinowo - hourly
miesięcznie - monthly
nocami - nightly
kwartalnie - quarterly
tygodniowo - weekly
